17 17 17 17 17 17 17 17 17 17 17 17 17 17 17 17 1
17 0 0 0 0 0 17 0 0 0 17 0 0 0 0 17 1
17 0 0 0 0 0 17 0 0 0 17 0 0 0 0 17 1
17 0 0 0 0 0 17 0 0 0 17 0 0 0 0 17 1
17 0 0 0 0 0 17 17 17 17 17 0 0 0 0 17 1
17 0 0 0 0 0 0 0 0 0 0 0 0 0 0 50 51
17 0 0 17 17 17 17 0 0 0 0 0 0 0 0 17 1
17 0 0 22 0 0 17 0 0 0 0 0 0 0 0 17 1
17 0 0 17 0 0 17 0 0 0 0 0 0 0 0 17 1
17 17 17 17 17 17 17 17 17 17 17 17 17 17 17 17 1
